1111111111111111
1P101111100001C1
1000G0000C000101
1010001111100101
101000000E1G0001
1111111111111111