1111111111111111
1P101111100001C1
100000000C000101
1010001111100101
101000000E100001
1111111111111111