11111111111111111111111111111111111
1P1000000000000000000001111100001C1
1000000000000000000000000000C000101
10100000000000000000000001111100101
1010000000000000000000000000E100001
10000000000000000000000000000000001
10000000000000000000000000000000001
10000000000000000000000000000000001
10000000000000000000000000000000001
10000000000000000000000000000000001
10000000000000000000000000000000001
10000000000000000000000000000000001
11111111111111111111111111111111111