11111111111111111111111111111111111
1P1000000001000000000101111100001C1
1000000000010000000001000000C000101
101000000001000C0000010001111100101
101000000G0100000G0001000000E100G01
10000000000000000000010000000000001
1000000000000000000001000C000000001
10000000000000000000010000000000001
11111111111100000000010000000000001
10C000000G0000000000010G00000000001
1000000000000000000001000000C000001
10000000000000C00G00000000000000001
11111111111111111111111111111111111
