111111111111111111111111111111111111111111111111111111111111111111111111111111111111111
1000000000000000C000000000000000011111111111111111111111G000000000000000000000000E00001
100000000000000000000000000000000111111111111111111111100000000000000000000000000000001
10000P000000000000000000000000000111111111111111111111100000000000000000000000000000001
100000000000000000000000000000000111111111111111111111100000000G00000000000000000000001
100000000000000000000000000000000111111111111111111111100000000000000000000000000000001
10000000000000000000000000000000011111111111111111111110000C000000000000000000000000001
100000000000000000000000000000000111111111111111111111100000000000000000000000000000001
10000000000000000000000000C0000001111111111111111111111000000000000000G0000000000000001
10000000000000000000000000000000011111111111111111111110000000000000000000000C000000001
100000000000C00G00000000000000000111111111111111111111100000000000000000000000000000001
1000000000000000000000000000000001111111111111111111111000000G0000000000000000000000001
100000000000000000000000000000000111111111111111111111100000000000000000000000000000001
100000000000000000000000000000000111111111111111111111100000000000000000000000000000001
100000000000000000000000000000000111111111111111111111100000000000000000000000000000001
100000000000000000000000000000000000000000000000000000000000000000000000000000000000001
100000000000000000000000000000000111111111111111111111100000000000000000000000000000001
10000000000000000000000000000000011111111111111111111110000000000000000000G000000000001
100000000000000000000000000000000111111111111111111111100000000000000000000000000000C01
10000000000000G000000000000000000111111111111111111111100000000000000000000000000000001
100000C00000000000000000000000000111111111111111111111100000000C00000000000000000000001
100000000000000000000000000000000111111111111111111111100000000000000000000000000000001
111111111111111111111111111111111111111111111111111111111111111111111111111111111111111
